NO ./textures/bloodyn.png
SO ./textures/bloodys.png
WE ./textures/bloodyw.png
EA ./textures/bloodye.png
F 130,0,0
C 0,0,0
        11111 111111111111
       10001  100000000001
      10001   101111110001
     10001    11    10001
    10001          10001
   10001          10001
  10001          10001
 10001          10001
10001111111111110001
10000000000000000001
1000000000S000000001
11111111000011110001    11
       100001  10001111101
       100001  10000000001
       111111  11111111111