NO ./textures/wall42.png
SO ./textures/wall_up2u.png
WE ./textures/wall_coal.png
EA ./textures/wall_taq.png
F 45,54,70
C 20,20,20
111111111111 1111111111111
100000000001 1000000000001
 100000000011100000000001
  100000000000000000000001
   1000000000000000000001
  1000000000N0000000000001
 100000000000000000000001
10000000000000000000000001
11111111111000111111111111
          11111