NO ./textures/bloodyn.png
SO ./textures/bloodys.png
WE ./textures/bloodyw.png
EA ./textures/bloodye.png
F 130,0,0
C 0,0,0
           1
 111111111101111111111
 100000000000000000001
 101111110000011111101
 101   100010001   101
 101  10000000001  101
 101 1001000001001 101
 101100000000000001101
 101000001111100000101
 100011000000000110001
 100000000000000000001
1000100000E000000010001
 100000000000000000001
 100011000000000110001
 101000001111100000101
 101100000000000001101
 101 1001000001001 101
 101  10000000001  101
 101   100010001   101
 101111110000011111101
 100000000000000000001
 111111111101111111111
           1