NO ./textures/wall42.png
SO ./textures/wall_up2u.png
WE ./textures/wall_coal.png
EA ./textures/wall_taq.png
F 110,153,15 
C 255,255,255

        1111111111111111111111111
        1000000000000000000000001
        1200000000000000000000001
        1000000000000000000000001
111111111000000000000000000000001
10000000000000EW00000000000001111
10000000000000000000000000001
10000000000000000000000000001
10000000000000000000000000001
10000000000000000000000000001
10000000000000000001010000001
11000001110101011111011110101
11110111 1110111 101111010001
11111111 1111111 111111111111
