NO ./textures/wall42.png
SO ./textures/wall_up2u.png
WE ./textures/wall_coal.png
EA ./textures/wall_taq.png
F 110,153,15 
C 255,255,255

        1111111111111111111111111
        1000000000000000000000001
        1100000000000000000000001
        1000000000000000000000001
111111111000000000000000000000001
100000000000000000000000000001111
100000000W00000111111100000001
1000000000000001     100000001
1000000000000001 111 100000001
1000000000000001 1011100000001
1000000000000001 1000000000001
1100000111010101 1111011110101
11110111 1110111 1011110100011
11111111 1111111 1111111110111
